R 690 420
NO textures/bluestone.xpm
SO textures/colorstone.xpm
WE textures/greystone.xpm
EA textures/redbrick.xpm
S textures/barrel.xpm
F 255,0,0
C 0,0,255
                      11111                    111    11111                             11111111111            
                    11000001                  100011 1000001                           1000000000001
                   100000001                  101000110000001                          1000000000001
       11  1  1   100000011           11  1   1000000000000001                      1110000000000001
      1001101101 11000001            10011011 1010001100000001                     10000000000000001
      100000000110020001  111       1000010001100001 10000000011                    1100101000000001
      100000000111000101 10001     1000000000110001  100000000001                   1000100000000001
     1001100000000001110110011    100100000001000011  100000000001                   110100000000001
    1101 100000000000000010000111 101 110000011000001  10000000001                    10100000000001
   100011 100000000000110000001001001  100000000000011110001001011                   100000020000001
   1000001 10000100000110001000000021   100000000000000111111001001                  100000000000001
  1000011   1100000111 10000000001001  1000020000020000000001100001                  10000E022222201
   10001      11011    10000000000001   1100000000000000011001000001                  11000000000001
   1000111      1     10000000000001   1110010100000000000000000011                   10000000000001
   10100001          10000000000111   1000001100000000011000111001                    10010000000001
    1 100011          1000110000001   1000001002000000110001 10001                    10000000000001
       110001 1        111  11000001  10000000000000001 1001 10100111                  1110000000001
        10000101            100000001  1000000000000001  11 1001000001111111             10000000001
         1000001            100001111  100000000000111      10010011010000001             1100000001
        100000001            10000110110000000000001        10000011000110001    1         102000001
         11000001           100000110000001000000001       10000001 111  1001   101       1100000001
         1000011111111111   100000100000001100000001       10000001      10001  101      10000000001
          1000110000000001111110000000110011000000001 1  11100000111    10011  11001  11111000000001
          1000010000000001000000000011  10000000000011011000000001001   10001 100001 100001100000001
          100000011001000000000000011111 10000000001100010001100000001111110110000001000000000000001
           11110011000000000000000000000110002000000100000000110001000000000010000000000001100000001
               11  1101100000000001000000000000000100000000001 1000000000011000001011000101 10000001
                     1 100000001000000000000000000000000000001 1000000000011101001100000001 1100001
                       11001000100000000000000000000000000000111000000000010000001 111011011000001
                      100000011100000000000000000000000000000001100000000000000001   101 110000001
                      10111001 100000000000000000000000000100001 11000000001000001  1100110000011
                      101  11  1000000000000000000000000000000011100000000001100001100001 11101
                      10011    100000000000100000000000000000000000010000111  1101000111     1
                      100001   10000000000200000000011000000110000001000111    100011
                       11100111000000000000000000111000000000000110010000001   1011
                          100000000000000000000001000000001100001 11 1100001    1
                         10000000000000020000001010000000010001001     1001
                         10000001000000000000000100000001110000001  11100001
                         10010011000000000000000010000001  1001101 100001001
                          100100000110000010010001102001  1 11  1  10001111
                           100000011000002000100011000001101001   110000001
                            11111000011000110100000111100000001  1000000001
                                 110011001  1 111101  10000001   1000000001
                                  101  11        10011000100001 10010000001
                                   1              101 110100101 1000010011
                                                  1001100111101100001111
                                                  10000001 1000000000001
                                                  10011001 1000000001001
                                                  1001 11 100001000000001
                                                  101     10001 100111001
                                                   1       111   11   11
